#$$$$)###%
#&##$)#'$$
##$+$)###$
##$#$#)##$
#$$$$##($$
#*##$$$$))
#$#,$##$+$
$$$#$#$$#$
$#+$$$$##$
$$$#$#$$$$
