##$$$$$$$$
#'##$####$
$$$$$$$#$$
$#$###$#$#
$#$###&#$+
$#$$$$##$#
$$#,#$#$$#
#$###$#$#*
$$$$$##$#$
$##$##$$$%
