$$$$$$$$#$
$#$$#$#$$$
$#$$$#$$$#
$#$##.##$#
$#$$$$##$#
$#$##$$#$#
$$#,####$#
#$#$#$$$$#
#$#$$$#$#$
%$$#&##$$$
