#######$##
$$$#$$$&$$
$#$$$####$
$###$$$$$$
$####*###$
$$$$$####$
#$#,$$$$$$
#$####$(((
$$$$$$$)$$
'##%###(#+
