$$$$$$$$$$
##$######$
##$$$$$##$
$$$##$###$
$###$$'##$
$$#######$
$##,##$$$$
$$$$$#$#$#
##$#$#$$$#
%$$$$##$##
