###%$$$###
######$$##
*$$$$##$##
####$$$$$+
+###$#$###
$###$$$###
$$#,##$##+
#$$$#'$$$$
###$###$#$
&$$$$$$$$$
