+####$$$#$
$##$$$#$$$
$$$$$###$#
##+#$$$$$#
####$###%#
#$$$$+##$#
#$#,####$#
#$#$$$$#$#
#$#$##$$$#
#$$$'###$&
