#$#$#$$$$$
#$$$$#$'#$
#$#+##$##+
#$$$$$$#$$
$$#$##$#$#
$##$$$$$$#
$$#,#$##$$
#%###$###$
##$$$$+$$$
$$$##&####
