#+#+#+####
#$$$$$$&##
#$#$######
#+#$$+##+#
####$###$#
$$$$$$+$$)
+#$,#$$$($
##$)))))#$
##($$$$$$$
)))##'#*#%
