$$$$$$###+
$####$%$$$
$##+#$###$
$##$$$$$$$
$$$$##$##$
$##$##$##$
$##,#$$$$$
$####&###$
$##$#$$$#$
$+$$###$$'
